{
  "tiles" : [ 0, 0, 1, 0, 0, 0, 1, 0, 0 ,
              0, 1, 1, 1, 1, 1, 1, 1, 0 ,
              1, 1, 0, 1, 1, 1, 0, 1, 1 ,
              1, 1, 1, 1, 1, 1, 1, 1, 1 ,
              0, 1, 1, 1, 1, 1, 1, 1, 0 ,
              1, 1, 1, 1, 1, 1, 1, 1, 1 ,
              1, 0, 1, 1, 1, 1, 1, 0, 1 ,
              1, 0, 1, 1, 1, 1, 1, 0, 1 ,
              0, 0, 1, 0, 0, 0, 1, 0, 0  ],

  "targetScore" : 7000,
  "moves" : 30, "rows":9, "cols":9
}
