{
  "tiles" : [ 0, 1, 1, 0, 0, 0, 1, 1, 0 ,
              1, 1, 1, 1, 1, 1, 1, 1, 1 ,
              1, 1, 1, 1, 1, 1, 1, 1, 1 ,
              1, 1, 1, 1, 1, 1, 1, 1, 1 ,
              0, 0, 1, 1, 1, 1, 1, 0, 0 ,
              1, 1, 1, 1, 1, 1, 1, 1, 1 ,
              1, 1, 1, 1, 1, 1, 1, 1, 1 ,
              1, 1, 1, 1, 1, 1, 1, 1, 1 ,
              0, 1, 1, 0, 0, 0, 1, 1, 0  ],
"timer" : 15, "rows":9, "cols":9,"targetScore" : 5000
}
