{
  "tiles" : [ 0, 0, 0, 0, 0, 0, 0, 0, 0 ,
              0, 0, 0, 0, 0, 0, 0, 0, 0 ,
              0, 0, 0, 0, 0, 0, 0, 0, 0 ,
              0, 0, 0, 1, 1, 1, 0, 0, 0 ,
              0, 0, 0, 1, 1, 1, 0, 0, 0 ,
              0, 0, 0, 1, 1, 1, 0, 0, 0 ,
              0, 0, 0, 0, 0, 0, 0, 0, 0 ,
              0, 0, 0, 0, 0, 0, 0, 0, 0 ,
              0, 0, 0, 0, 0, 0, 0, 0, 0  ],

  "targetScore" : 1000,
  "moves" : 15
}
